..................................................................................................
..................................................#################################...............
..................................................#...............................#...............
..................................................#...............................#...............
..................................................#...............................#...............
..................................................#...............................#...............
..................................................#...............................#...............
..................................................#...............................#...............
..................................................#...............................#...............
..................................................#...............................#...............
.......................#######+########...........#...............................#...............
.......................#..............#############...............................#...............
.......................#..............+...........+...............................#...............
.......................#..............#############...............................#...............
.......................+..............#...........#...............................#...............
.......................#..............#...........#...............................#...............
.......................#######+########...........#...............................#...............
..................................................#...............................#...............
..................................................#...............................#...............
..................................................#################################...............
..................................................................................................
..................................................................................................
..................................................................................................